12,18,12,18,12,18,12,18,32,32,32,32,32,32,32,32
12,12,12,12,12,12,12,12,32,34,32,32,32,33,32,32
12,18,12,18,12,18,12,18,32,32,32,32,32,32,32,32
12,12,12,12,12,12,12,12,32,32,32,32,32,32,32,32
12,18,12,18,12,18,12,18,12,18,12,18,12,18,12,18
12,12,12,12,12,12,12,12,12,12,12,12,12,12,12,12
12,18,12,18,12,18,12,18,12,18,12,18,12,18,12,18
11,11,11,11,11,11,14,11,11,11,15,11,11,11,11,11
19,19,30,24,31,2,2,2,2,2,2,2,2,2,2,2
19,19,28,22,29,2,2,2,2,2,2,2,2,2,2,2
19,19,26,24,27,2,2,2,2,2,2,2,2,2,2,2
7,7,7,7,7,7,7,7,7,7,7,7,7,7,7,7
16,16,16,16,16,16,16,16,16,16,16,3,3,16,16,16
17,17,17,17,17,17,17,17,17,17,17,3,3,17,17,17
6,6,6,6,6,6,6,6,6,6,6,6,6,6,6,6
6,6,6,6,6,6,6,6,6,6,6,6,6,6,6,6
